+                                                                      +
|                                                                      |
|                                                                      |
|                                                                      |
|                                                                      |
|                                                                      |
|                               +-------*                              |
|                                                                      |
|              +---o+                                                  |
|                                                                      |
|                                                                      |
|                                                                      |
|                                                         +O---+       |
|      +---------------------------+                                   |
|      |                           |                                   |
|      |                           |                                   |
|      |                           +---------------------------+       |
|      |                                                       |       |
|      |                                                       |       |
|      +---------------------------+---------------------------+       |
|                                                                      |
|                                                                      |
|   @                                                                  |
+      +---------------------------------------------------------------+
|      |
+------+
