+                                                                      +
|                                                                      |
|                                                                      |
|                                                                      |
|                                                                      |
|                                                                      |
|                                                                      |
|                                                                      |
|                                                                      |
|                                                                      |
|                              +------------*                          |
|                                                                      |
|                                                                      |
|      +---------------------------+                                   |
|      |                           |                                   |
|      |                           |                                   |
|      |                           +---------------------------+       |
|      |                                                       |       |
|      |                                                       |       |
|      +---------------------------+---------------------------+       |
|                                                                      |
+----------------------------------------------------------------------+